rank_debiased,bgg_id,name,year,rank,avg_rating,avg_rating_debiased,avg_rating_change,avg_rating_bayes_debiased,rank_change
48,811,Rummikub,1977,1698,6.472,7.546,1.074,7.319,1650
27,327,Loopin' Louie,1992,1164,6.748,7.931,1.183,7.447,1137
97,17329,Animal Upon Animal,2005,1141,6.789,7.590,0.801,7.136,1044
34,1465,Wizard,1984,844,6.968,7.810,0.842,7.416,810
2,41,Can't Stop,1980,774,6.906,8.172,1.266,7.868,772
81,15512,Incan Gold,2005,852,6.833,7.360,0.527,7.176,771
8,432,Take 5,1994,645,6.963,7.799,0.835,7.627,637
22,699,HeroQuest,1989,656,7.198,7.812,0.614,7.473,634
61,1353,Time's Up!,1999,679,7.284,7.974,0.690,7.271,618
60,5782,Coloretto,2003,655,6.979,7.473,0.494,7.277,595
32,220,High Society,1995,544,7.157,7.757,0.599,7.420,512
31,11,Bohnanza,1997,517,7.049,7.523,0.474,7.424,486
87,133473,Sushi Go!,2013,571,7.008,7.243,0.235,7.160,484
28,12942,No Thanks!,2004,500,7.077,7.608,0.531,7.439,472
35,150,PitchCar,1995,497,7.266,7.815,0.549,7.415,462
93,13,CATAN,1995,540,7.100,7.176,0.076,7.146,447
56,92415,Skull,2011,430,7.194,7.466,0.273,7.285,374
23,39856,Dixit,2008,391,7.198,7.535,0.337,7.466,368
44,372,Schotten Totten,1999,405,7.355,7.715,0.361,7.340,361
72,70323,King of Tokyo,2011,413,7.136,7.267,0.131,7.210,341
3,172,For Sale,1997,329,7.250,7.941,0.690,7.768,326
1,2653,Survive: Escape from Atlantis!,1982,324,7.315,8.230,0.916,8.005,323
78,41114,The Resistance,2009,400,7.212,7.295,0.083,7.200,322
9,50,Lost Cities,1999,325,7.233,7.734,0.501,7.626,316
33,129622,Love Letter,2012,327,7.225,7.483,0.258,7.417,294
62,47,Chinatown,1999,354,7.428,7.633,0.205,7.266,292
18,46213,Telestrations,2009,307,7.385,7.763,0.378,7.503,289
21,760,Battle Line,2000,294,7.414,7.752,0.338,7.489,273
26,92828,Dixit: Odyssey,2011,291,7.403,7.666,0.263,7.450,265
46,204583,Kingdomino,2016,294,7.306,7.412,0.105,7.324,248
50,156546,Monikers,2015,292,7.784,7.971,0.187,7.315,242
68,2655,Hive,2001,299,7.320,7.329,0.009,7.222,231
90,160477,Onitama,2014,309,7.353,7.331,-0.022,7.154,219
19,9209,Ticket to Ride,2004,230,7.394,7.543,0.149,7.491,211
6,215,Tichu,1991,215,7.579,7.977,0.399,7.653,209
43,192291,Sushi Go Party!,2016,250,7.400,7.470,0.069,7.344,207
59,3,Samurai,1998,264,7.465,7.532,0.067,7.278,205
7,118,Modern Art,1992,212,7.496,7.872,0.376,7.645,205
10,822,Carcassonne,2000,214,7.411,7.645,0.235,7.606,204
92,31481,Galaxy Trucker,2007,284,7.342,7.259,-0.083,7.148,192
11,54043,Jaipur,2009,188,7.488,7.693,0.205,7.600,177
71,165722,KLASK,2014,247,7.632,7.613,-0.020,7.211,176
88,198994,Hero Realms,2016,263,7.523,7.376,-0.146,7.159,175
89,194655,Santorini,2016,256,7.369,7.257,-0.113,7.156,167
75,158600,Hanamikoji,2013,239,7.497,7.432,-0.065,7.203,164
77,156129,Deception: Murder in Hong Kong,2014,237,7.459,7.381,-0.077,7.200,160
94,199478,Flamme Rouge,2016,253,7.496,7.361,-0.135,7.145,159
83,188834,Secret Hitler,2016,234,7.512,7.317,-0.195,7.173,151
52,31627,Ticket to Ride: Nordic Countries,2007,201,7.627,7.603,-0.024,7.304,149
64,148228,Splendor,2014,213,7.424,7.296,-0.127,7.245,149
5,2511,Sherlock Holmes Consulting Detective: The Thames Murders & Other Cases,1982,151,7.640,7.926,0.286,7.686,146
53,128882,The Resistance: Avalon,2012,196,7.519,7.429,-0.091,7.303,143
14,14996,Ticket to Ride: Europe,2005,155,7.529,7.598,0.069,7.535,141
80,182631,Star Realms: Colony Wars,2015,216,7.803,7.665,-0.138,7.181,136
13,12,Ra,1999,138,7.606,7.743,0.137,7.551,125
39,463,Magic: The Gathering,1993,164,7.576,7.490,-0.086,7.380,125
12,178900,Codenames,2015,129,7.547,7.614,0.068,7.561,117
42,147020,Star Realms,2014,158,7.561,7.439,-0.122,7.345,116
41,254640,Just One,2018,142,7.601,7.510,-0.090,7.348,101
85,209418,Dominion (Second Edition),2016,181,7.835,7.535,-0.300,7.166,96
91,294484,Unmatched: Cobble & Fog,2020,186,7.972,7.644,-0.327,7.154,95
38,36218,Dominion,2008,129,7.599,7.434,-0.165,7.386,91
20,291453,SCOUT,2019,105,7.824,7.765,-0.059,7.491,85
74,118048,Targi,2012,152,7.611,7.370,-0.241,7.205,78
49,163412,Patchwork,2014,126,7.594,7.380,-0.214,7.317,77
15,93,El Grande,1995,91,7.756,7.676,-0.081,7.517,76
45,40834,Dominion: Intrigue,2009,112,7.690,7.458,-0.233,7.332,67
96,263918,Cartographers,2019,153,7.597,7.262,-0.335,7.137,57
67,217372,The Quest for El Dorado,2017,123,7.688,7.378,-0.310,7.227,56
40,110327,Lords of Waterdeep,2012,88,7.733,7.427,-0.306,7.351,48
63,225694,Decrypto,2018,100,7.769,7.432,-0.337,7.257,37
47,230802,Azul,2017,79,7.744,7.366,-0.378,7.321,32
36,244521,The Quacks of Quedlinburg,2018,67,7.822,7.500,-0.322,7.413,31
73,68448,7 Wonders,2010,94,7.680,7.246,-0.435,7.208,21
30,3076,Puerto Rico,2002,45,7.914,7.491,-0.423,7.428,15
4,173346,7 Wonders Duel,2015,19,8.095,7.784,-0.310,7.731,15
99,42,Tigris & Euphrates,1997,111,7.703,7.261,-0.442,7.131,12
51,2651,Power Grid,2004,62,7.809,7.375,-0.434,7.311,11
100,170042,Raiders of the North Sea,2015,110,7.737,7.278,-0.459,7.124,10
82,28143,Race for the Galaxy,2007,80,7.744,7.244,-0.500,7.175,-2
29,266507,Clank! Legacy: Acquisitions Incorporated,2019,22,8.532,7.894,-0.638,7.430,-7
55,295947,Cascadia,2021,48,7.944,7.398,-0.547,7.295,-7
24,84876,The Castles of Burgundy,2011,16,8.141,7.527,-0.615,7.455,-8
16,167791,Terraforming Mars,2016,7,8.356,7.551,-0.806,7.504,-9
106,279537,The Search for Planet X,2020,96,7.942,7.414,-0.528,7.120,-10
37,124361,Concordia,2013,24,8.093,7.507,-0.586,7.400,-13
17,161936,Pandemic Legacy: Season 1,2015,2,8.525,7.590,-0.935,7.504,-15
57,366013,Heat: Pedal to the Metal,2022,41,8.055,7.449,-0.606,7.284,-16
102,201808,Clank!: A Deck-Building Adventure,2016,83,7.776,7.211,-0.565,7.123,-19
25,316554,Dune: Imperium,2020,6,8.435,7.547,-0.888,7.451,-19
79,253344,Cthulhu: Death May Die,2019,58,8.183,7.492,-0.691,7.190,-21
76,170216,Blood Rage,2015,52,7.924,7.283,-0.641,7.201,-24
58,164928,Orléans,2014,32,8.060,7.409,-0.651,7.280,-26
65,183394,Viticulture Essential Edition,2015,38,7.986,7.319,-0.667,7.237,-27
86,205059,Mansions of Madness: Second Edition,2016,59,7.944,7.266,-0.678,7.162,-27
66,324856,The Crew: Mission Deep Sea,2021,37,8.139,7.445,-0.694,7.229,-29
105,284083,The Crew: The Quest for Planet Nine,2019,75,7.798,7.208,-0.590,7.120,-30
69,266192,Wingspan,2019,30,8.041,7.261,-0.780,7.220,-39
121,157354,Five Tribes: The Djinns of Naqala,2014,81,7.775,7.158,-0.616,7.072,-40
54,187645,Star Wars: Rebellion,2016,9,8.417,7.424,-0.993,7.298,-45
131,124742,Android: Netrunner,2012,73,7.884,7.169,-0.715,7.051,-58
107,285774,Marvel Champions: The Card Game,2019,40,8.120,7.261,-0.859,7.107,-67
70,224517,Brass: Birmingham,2018,1,8.594,7.299,-1.296,7.215,-69
98,312484,Lost Ruins of Arnak,2020,28,8.072,7.215,-0.857,7.132,-70
149,209010,Mechs vs. Minions,2016,74,7.968,7.221,-0.748,7.021,-75
95,169786,Scythe,2016,17,8.138,7.188,-0.950,7.143,-78
84,342942,Ark Nova,2021,4,8.536,7.251,-1.285,7.166,-80
111,28720,Brass: Lancashire,2007,20,8.195,7.246,-0.949,7.099,-91
193,256916,Concordia Venus,2018,97,8.290,7.481,-0.808,6.937,-96
169,164153,Star Wars: Imperial Assault,2014,72,7.963,7.114,-0.849,6.977,-97
183,373106,Sky Team,2023,76,8.195,7.303,-0.892,6.955,-107
180,182874,Grand Austria Hotel,2015,63,7.949,7.120,-0.829,6.962,-117
157,199792,Everdell,2018,36,8.022,7.069,-0.953,7.007,-121
222,365717,Clank!: Catacombs,2022,99,8.275,7.386,-0.889,6.893,-123
181,31260,Agricola,2007,54,7.873,7.007,-0.866,6.961,-127
213,191189,Aeon's End,2016,84,7.898,7.067,-0.831,6.912,-129
177,397598,Dune: Imperium – Uprising,2023,44,8.734,7.524,-1.210,6.964,-133
147,12333,Twilight Struggle,2005,13,8.245,7.093,-1.152,7.021,-134
162,193738,Great Western Trail,2016,15,8.188,7.073,-1.115,6.990,-147
165,246900,Eclipse: Second Dawn for the Galaxy,2020,18,8.454,7.229,-1.224,6.985,-147
194,167355,Nemesis,2018,21,8.266,7.043,-1.224,6.937,-173
236,231733,Obsession,2018,60,8.140,7.117,-1.022,6.874,-176
276,171623,The Voyages of Marco Polo,2015,93,7.781,6.943,-0.837,6.822,-183
206,174430,Gloomhaven,2017,3,8.583,6.973,-1.610,6.921,-203
269,126163,Tzolk'in: The Mayan Calendar,2012,61,7.857,6.904,-0.953,6.827,-208
283,251661,Oathsworn: Into the Deepwood,2022,65,8.959,7.422,-1.537,6.816,-218
289,35677,Le Havre,2008,69,7.848,6.905,-0.942,6.811,-220
316,317985,Beyond the Sun,2020,87,7.917,6.987,-0.931,6.788,-229
260,205637,Arkham Horror: The Card Game,2016,27,8.130,6.916,-1.214,6.845,-233
266,120677,Terra Mystica,2012,29,8.059,6.892,-1.168,6.828,-237
274,341169,Great Western Trail: Second Edition,2021,26,8.328,7.052,-1.276,6.822,-248
298,247763,Underwater Cities,2018,43,8.059,6.956,-1.103,6.805,-255
341,200680,Agricola (Revised Edition),2016,78,7.958,6.921,-1.037,6.762,-263
301,177736,A Feast for Odin,2016,23,8.171,6.905,-1.265,6.802,-278
361,72125,Eclipse: New Dawn for the Galaxy,2011,82,7.830,6.844,-0.985,6.743,-279
377,216132,Clans of Caledonia,2017,68,7.940,6.871,-1.070,6.733,-309
366,255984,Sleeping Gods,2021,55,8.195,6.969,-1.226,6.740,-311
371,314040,Pandemic Legacy: Season 0,2020,53,8.392,7.103,-1.289,6.739,-318
331,115746,War of the Ring: Second Edition,2011,8,8.543,6.907,-1.636,6.772,-323
375,102794,Caverna: The Cave Farmers,2013,49,7.944,6.816,-1.129,6.735,-326
348,162886,Spirit Island,2017,11,8.344,6.811,-1.533,6.756,-337
347,291457,Gloomhaven: Jaws of the Lion,2020,10,8.429,6.840,-1.589,6.757,-337
431,25613,Through the Ages: A Story of Civilization,2006,90,7.840,6.820,-1.019,6.680,-341
355,182028,Through the Ages: A New Story of Civilization,2015,14,8.282,6.842,-1.440,6.752,-341
477,264220,Tainted Grail: The Fall of Avalon,2019,98,8.090,6.861,-1.229,6.651,-379
398,220308,Gaia Project,2017,12,8.372,6.813,-1.559,6.712,-386
493,159675,Fields of Arle,2014,85,8.030,6.875,-1.155,6.639,-408
457,256960,Pax Pamir: Second Edition,2019,42,8.182,6.847,-1.335,6.662,-415
513,62219,Dominant Species,2010,92,7.814,6.751,-1.064,6.629,-421
496,266810,Paladins of the West Kingdom,2019,70,7.979,6.782,-1.197,6.637,-426
492,221107,Pandemic Legacy: Season 2,2017,57,8.029,6.794,-1.236,6.639,-435
531,55690,Kingdom Death: Monster,2015,77,8.494,6.872,-1.622,6.609,-454
519,175914,Food Chain Magnate,2015,39,8.056,6.751,-1.305,6.625,-480
579,192135,Too Many Bones,2017,33,8.340,6.764,-1.576,6.583,-546
644,229853,Teotihuacan: City of Gods,2018,86,7.863,6.664,-1.199,6.544,-558
619,185343,Anachrony,2017,50,8.070,6.689,-1.381,6.560,-569
607,251247,Barrage,2019,35,8.162,6.700,-1.462,6.564,-572
654,321608,Hegemony: Lead Your Class to Victory,2023,66,8.463,6.873,-1.589,6.536,-588
681,284378,Kanban EV,2020,46,8.418,6.819,-1.599,6.521,-635
682,295770,Frosthaven,2022,25,8.826,6.843,-1.983,6.520,-657
750,383179,Age of Innovation,2023,89,8.669,6.984,-1.685,6.477,-661
739,276025,Maracaibo,2019,64,8.011,6.619,-1.392,6.482,-675
780,125153,The Gallerist,2015,71,8.021,6.609,-1.412,6.460,-709
871,121921,Robinson Crusoe: Adventures on the Cursed Island,2012,95,7.741,6.462,-1.279,6.414,-776
1016,161533,Lisboa,2017,56,8.188,6.524,-1.664,6.350,-960
1032,96848,Mage Knight Board Game,2011,34,8.085,6.402,-1.683,6.344,-998
1139,237182,Root,2018,31,8.072,6.332,-1.739,6.297,-1108
1174,184267,On Mars,2020,51,8.187,6.420,-1.768,6.280,-1123
