rank_debiased,bgg_id,name,year,rank,avg_rating,avg_rating_debiased,avg_rating_change,avg_rating_bayes_debiased,rank_change
90,432,Take 5,1994,645,6.963,7.428,0.465,7.284,555
57,133473,Sushi Go!,2013,571,7.008,7.495,0.487,7.399,514
97,117959,Las Vegas,2012,579,7.160,7.636,0.477,7.267,482
98,147949,One Night Ultimate Werewolf,2014,566,7.068,7.418,0.350,7.266,468
53,12942,No Thanks!,2004,500,7.077,7.580,0.503,7.413,447
66,150,PitchCar,1995,497,7.266,7.774,0.508,7.381,431
51,274960,Point Salad,2019,482,7.161,7.655,0.494,7.417,431
95,193042,Junk Art,2016,515,7.371,7.822,0.451,7.271,420
47,262543,Wavelength,2019,447,7.287,7.798,0.511,7.441,400
33,92415,Skull,2011,430,7.194,7.708,0.515,7.505,397
49,198773,Codenames: Pictures,2016,431,7.195,7.631,0.437,7.431,382
26,39856,Dixit,2008,391,7.198,7.661,0.463,7.587,365
69,70323,King of Tokyo,2011,413,7.136,7.417,0.281,7.355,344
30,277085,Love Letter,2019,369,7.516,8.022,0.505,7.516,339
76,41114,The Resistance,2009,400,7.212,7.427,0.215,7.324,324
23,129622,Love Letter,2012,327,7.225,7.696,0.470,7.622,304
41,329839,So Clover!,2021,342,7.591,8.114,0.523,7.473,301
29,172,For Sale,1997,329,7.250,7.679,0.428,7.525,300
19,46213,Telestrations,2009,307,7.385,7.926,0.541,7.647,288
18,204583,Kingdomino,2016,294,7.306,7.750,0.444,7.647,276
50,50,Lost Cities,1999,325,7.233,7.519,0.286,7.422,275
20,92828,Dixit: Odyssey,2011,291,7.403,7.885,0.482,7.647,271
27,156546,Monikers,2015,292,7.784,8.317,0.532,7.568,265
83,2653,Survive: Escape from Atlantis!,1982,324,7.315,7.464,0.149,7.302,241
73,160477,Onitama,2014,309,7.353,7.524,0.171,7.329,236
14,165722,KLASK,2014,247,7.632,8.182,0.550,7.672,233
17,192291,Sushi Go Party!,2016,250,7.400,7.797,0.397,7.650,233
11,318977,MicroMacro: Crime City,2020,242,7.518,8.034,0.516,7.698,231
35,260605,Camel Up (Second Edition),2018,259,7.581,7.876,0.296,7.490,224
77,239188,Chronicles of Crime,2018,287,7.581,7.500,-0.080,7.317,210
25,224037,Codenames: Duet,2017,231,7.454,7.812,0.358,7.591,206
93,298047,Marvel United,2020,298,7.579,7.655,0.076,7.281,205
55,199478,Flamme Rouge,2016,253,7.496,7.651,0.156,7.402,198
42,156129,Deception: Murder in Hong Kong,2014,237,7.459,7.680,0.221,7.470,195
63,194655,Santorini,2016,256,7.369,7.500,0.131,7.386,193
72,198994,Hero Realms,2016,263,7.523,7.569,0.047,7.330,191
44,188834,Secret Hitler,2016,234,7.512,7.632,0.120,7.463,190
60,158600,Hanamikoji,2013,239,7.497,7.651,0.154,7.396,179
62,232832,Century: Golem Edition,2017,241,7.602,7.757,0.155,7.391,179
54,9209,Ticket to Ride,2004,230,7.394,7.459,0.065,7.409,176
13,54043,Jaipur,2009,188,7.488,7.784,0.296,7.687,175
45,148228,Splendor,2014,213,7.424,7.520,0.096,7.462,168
79,223040,Fantasy Realms,2017,246,7.523,7.601,0.078,7.313,167
34,128882,The Resistance: Avalon,2012,196,7.519,7.643,0.124,7.503,162
91,274637,"Unmatched: Battle of Legends, Volume One",2019,251,7.755,7.764,0.010,7.282,160
56,822,Carcassonne,2000,214,7.411,7.436,0.025,7.400,158
1,254640,Just One,2018,142,7.601,8.162,0.561,7.947,141
46,233867,Welcome To...,2018,185,7.532,7.592,0.060,7.449,139
81,182631,Star Realms: Colony Wars,2015,216,7.803,7.825,0.022,7.306,135
65,199561,Sagrada,2017,200,7.478,7.489,0.011,7.383,135
48,244522,That's Pretty Clever!,2018,182,7.571,7.614,0.043,7.434,134
2,178900,Codenames,2015,129,7.547,7.969,0.423,7.908,127
61,294484,Unmatched: Cobble & Fog,2020,186,7.972,7.953,-0.019,7.392,125
75,282524,Horrified,2019,199,7.647,7.584,-0.063,7.326,124
82,31627,Ticket to Ride: Nordic Countries,2007,201,7.627,7.602,-0.025,7.303,119
9,163412,Patchwork,2014,126,7.594,7.802,0.208,7.725,117
39,14996,Ticket to Ride: Europe,2005,155,7.529,7.539,0.010,7.478,116
43,147020,Star Realms,2014,158,7.561,7.568,0.007,7.467,115
38,263918,Cartographers,2019,153,7.597,7.632,0.035,7.481,115
89,287954,Azul: Summer Pavilion,2019,199,7.628,7.549,-0.079,7.287,110
4,291453,SCOUT,2019,105,7.824,8.188,0.364,7.862,101
85,209418,Dominion (Second Edition),2016,181,7.835,7.696,-0.139,7.298,96
32,217372,The Quest for El Dorado,2017,123,7.688,7.683,-0.005,7.507,91
31,364073,Splendor Duel,2022,120,7.928,7.901,-0.026,7.509,89
99,329082,Radlands,2021,183,7.835,7.639,-0.195,7.264,84
21,225694,Decrypto,2018,100,7.769,7.845,0.076,7.632,79
8,230802,Azul,2017,79,7.744,7.850,0.106,7.792,71
100,268864,Undaunted: Normandy,2019,167,7.806,7.618,-0.189,7.263,67
67,266524,PARKS,2019,133,7.679,7.556,-0.122,7.376,66
15,284083,The Crew: The Quest for Planet Nine,2019,75,7.798,7.786,-0.012,7.668,60
10,244521,The Quacks of Quedlinburg,2018,67,7.822,7.815,-0.007,7.715,57
24,373106,Sky Team,2023,76,8.195,8.129,-0.066,7.621,52
37,201808,Clank!: A Deck-Building Adventure,2016,83,7.776,7.593,-0.183,7.486,46
3,295947,Cascadia,2021,48,7.944,7.998,0.053,7.863,45
86,36218,Dominion,2008,129,7.599,7.340,-0.258,7.295,43
58,68448,7 Wonders,2010,94,7.680,7.440,-0.240,7.398,36
7,324856,The Crew: Mission Deep Sea,2021,37,8.139,8.079,-0.059,7.793,30
12,366013,Heat: Pedal to the Metal,2022,41,8.055,7.891,-0.164,7.688,29
36,253344,Cthulhu: Death May Die,2019,58,8.183,7.842,-0.341,7.487,22
71,110327,Lords of Waterdeep,2012,88,7.733,7.408,-0.325,7.332,17
96,40834,Dominion: Intrigue,2009,112,7.690,7.390,-0.300,7.269,16
80,279537,The Search for Planet X,2020,96,7.942,7.641,-0.302,7.312,16
59,209010,Mechs vs. Minions,2016,74,7.968,7.647,-0.321,7.398,15
16,266192,Wingspan,2019,30,8.041,7.707,-0.334,7.655,14
6,173346,7 Wonders Duel,2015,19,8.095,7.911,-0.184,7.855,13
92,365717,Clank!: Catacombs,2022,99,8.275,7.914,-0.362,7.282,7
5,161936,Pandemic Legacy: Season 1,2015,2,8.525,7.963,-0.562,7.862,-3
28,266507,Clank! Legacy: Acquisitions Incorporated,2019,22,8.532,8.030,-0.502,7.539,-6
70,205059,Mansions of Madness: Second Edition,2016,59,7.944,7.471,-0.473,7.354,-11
22,316554,Dune: Imperium,2020,6,8.435,7.735,-0.700,7.630,-16
64,199792,Everdell,2018,36,8.022,7.463,-0.560,7.385,-28
40,167791,Terraforming Mars,2016,7,8.356,7.522,-0.834,7.477,-33
52,84876,The Castles of Burgundy,2011,16,8.141,7.486,-0.655,7.416,-36
78,285774,Marvel Champions: The Card Game,2019,40,8.120,7.490,-0.630,7.316,-38
68,312484,Lost Ruins of Arnak,2020,28,8.072,7.452,-0.620,7.358,-40
84,183394,Viticulture Essential Edition,2015,38,7.986,7.385,-0.601,7.300,-46
74,124361,Concordia,2013,24,8.093,7.431,-0.662,7.328,-50
107,170216,Blood Rage,2015,52,7.924,7.329,-0.594,7.245,-55
146,191189,Aeon's End,2016,84,7.898,7.346,-0.551,7.164,-62
105,164928,Orléans,2014,32,8.060,7.375,-0.685,7.248,-73
87,342942,Ark Nova,2021,4,8.536,7.385,-1.151,7.294,-83
88,224517,Brass: Birmingham,2018,1,8.594,7.376,-1.218,7.288,-87
94,174430,Gloomhaven,2017,3,8.583,7.341,-1.242,7.275,-91
176,157354,Five Tribes: The Djinns of Naqala,2014,81,7.775,7.203,-0.571,7.114,-95
108,291457,Gloomhaven: Jaws of the Lion,2020,10,8.429,7.356,-1.073,7.242,-98
156,314040,Pandemic Legacy: Season 0,2020,53,8.392,7.629,-0.763,7.145,-103
169,251661,Oathsworn: Into the Deepwood,2022,65,8.959,7.873,-1.086,7.125,-104
171,231733,Obsession,2018,60,8.140,7.407,-0.733,7.120,-111
155,397598,Dune: Imperium – Uprising,2023,44,8.734,7.779,-0.955,7.148,-111
138,167355,Nemesis,2018,21,8.266,7.302,-0.965,7.178,-117
225,256916,Concordia Venus,2018,97,8.290,7.611,-0.679,7.030,-128
144,187645,Star Wars: Rebellion,2016,9,8.417,7.284,-1.133,7.167,-135
157,169786,Scythe,2016,17,8.138,7.189,-0.949,7.144,-140
195,255984,Sleeping Gods,2021,55,8.195,7.374,-0.821,7.083,-140
234,28143,Race for the Galaxy,2007,80,7.744,7.081,-0.663,7.018,-154
175,246900,Eclipse: Second Dawn for the Galaxy,2020,18,8.454,7.382,-1.072,7.116,-157
251,93,El Grande,1995,91,7.756,7.107,-0.649,6.990,-160
174,12333,Twilight Struggle,2005,13,8.245,7.193,-1.052,7.117,-161
281,264220,Tainted Grail: The Fall of Avalon,2019,98,8.090,7.198,-0.892,6.937,-183
229,3076,Puerto Rico,2002,45,7.914,7.076,-0.838,7.027,-184
274,317985,Beyond the Sun,2020,87,7.917,7.170,-0.747,6.947,-187
262,164153,Star Wars: Imperial Assault,2014,72,7.963,7.104,-0.859,6.967,-190
217,205637,Arkham Horror: The Card Game,2016,27,8.130,7.121,-1.009,7.040,-190
248,221107,Pandemic Legacy: Season 2,2017,57,8.029,7.201,-0.828,6.998,-191
255,182874,Grand Austria Hotel,2015,63,7.949,7.146,-0.803,6.985,-192
286,2651,Power Grid,2004,62,7.809,6.982,-0.828,6.931,-224
249,193738,Great Western Trail,2016,15,8.188,7.080,-1.108,6.996,-234
267,341169,Great Western Trail: Second Edition,2021,26,8.328,7.209,-1.119,6.956,-241
336,171623,The Voyages of Marco Polo,2015,93,7.781,6.999,-0.782,6.872,-243
266,115746,War of the Ring: Second Edition,2011,8,8.543,7.111,-1.432,6.957,-258
280,162886,Spirit Island,2017,11,8.344,7.004,-1.340,6.941,-269
311,192135,Too Many Bones,2017,33,8.340,7.135,-1.205,6.901,-278
363,124742,Android: Netrunner,2012,73,7.884,6.958,-0.926,6.854,-290
349,247763,Underwater Cities,2018,43,8.059,7.023,-1.036,6.866,-306
387,200680,Agricola (Revised Edition),2016,78,7.958,7.004,-0.954,6.835,-309
388,216132,Clans of Caledonia,2017,68,7.940,6.984,-0.957,6.834,-320
352,295770,Frosthaven,2022,25,8.826,7.295,-1.532,6.863,-327
351,28720,Brass: Lancashire,2007,20,8.195,6.989,-1.206,6.864,-331
361,177736,A Feast for Odin,2016,23,8.171,6.964,-1.207,6.856,-338
381,237182,Root,2018,31,8.072,6.898,-1.173,6.840,-350
457,31260,Agricola,2007,54,7.873,6.805,-1.068,6.765,-403
482,55690,Kingdom Death: Monster,2015,77,8.494,7.032,-1.462,6.739,-405
448,256960,Pax Pamir: Second Edition,2019,42,8.182,6.976,-1.206,6.773,-406
525,266810,Paladins of the West Kingdom,2019,70,7.979,6.858,-1.121,6.704,-455
518,102794,Caverna: The Cave Farmers,2013,49,7.944,6.787,-1.157,6.708,-469
530,126163,Tzolk'in: The Mayan Calendar,2012,61,7.857,6.770,-1.087,6.700,-469
504,120677,Terra Mystica,2012,29,8.059,6.780,-1.279,6.722,-475
496,220308,Gaia Project,2017,12,8.372,6.828,-1.543,6.726,-484
575,321608,Hegemony: Lead Your Class to Victory,2023,66,8.463,7.042,-1.420,6.663,-509
600,35677,Le Havre,2008,69,7.848,6.728,-1.119,6.646,-531
626,383179,Age of Innovation,2023,89,8.669,7.218,-1.450,6.631,-537
635,72125,Eclipse: New Dawn for the Galaxy,2011,82,7.830,6.719,-1.111,6.627,-553
597,251247,Barrage,2019,35,8.162,6.793,-1.369,6.647,-562
628,185343,Anachrony,2017,50,8.070,6.769,-1.302,6.631,-578
676,159675,Fields of Arle,2014,85,8.030,6.832,-1.198,6.604,-591
668,276025,Maracaibo,2019,64,8.011,6.764,-1.246,6.610,-604
629,182028,Through the Ages: A New Story of Civilization,2015,14,8.282,6.712,-1.571,6.630,-615
710,229853,Teotihuacan: City of Gods,2018,86,7.863,6.706,-1.157,6.582,-624
673,284378,Kanban EV,2020,46,8.418,6.931,-1.487,6.608,-627
834,121921,Robinson Crusoe: Adventures on the Cursed Island,2012,95,7.741,6.559,-1.183,6.506,-739
805,175914,Food Chain Magnate,2015,39,8.056,6.635,-1.421,6.521,-766
849,96848,Mage Knight Board Game,2011,34,8.085,6.560,-1.525,6.491,-815
982,125153,The Gallerist,2015,71,8.021,6.573,-1.449,6.428,-911
1057,62219,Dominant Species,2010,92,7.814,6.492,-1.322,6.395,-965
1153,161533,Lisboa,2017,56,8.188,6.528,-1.660,6.353,-1097
1191,25613,Through the Ages: A Story of Civilization,2006,90,7.840,6.432,-1.408,6.333,-1101
1217,184267,On Mars,2020,51,8.187,6.468,-1.719,6.321,-1166
